20 15
TERRAIN
.. TRUE TRUE sprites.png 5 3
## FALSE FALSE sprites.png 7 2
TT FALSE TRUE sprites.png 10 2
START
........................................
..................................TT....
..................TT....................
........................................
........................................
..##........##........................TT
..##........##..........................
..############..........................
........................TT..............
..TT....................................
........................................
................................TT......
............TT..........................
........................................
........................................
END
UNITS
aa TRUE
bb FALSE
START
........................................
..................................TT....
..................TT....................
........................................
........................................
..##........##........................TT
..##..bb....##..........................
..############..........................
........................TT..............
..TT....................................
..............aaaaaaaaaaaa..............
................aaaaaaaaaaaa....TT......
....aaaa....TT......aaaaaaaaaa..........
......aa..................aaaaaa........
........................................
END
