30 30
TERRAIN
.. TRUE TRUE sprites.png 5 3
## FALSE FALSE sprites.png 7 2
START
############################################################
##................##..........##..........................##
################..##########..######..##############..##..##
##........##..##..##......##..##..##..##..........##..##..##
##..####..##......##..######..##..##..##..##########..##..##
##....##..######..##..##......##..##..##..........##..##..##
####..##......##..##..######..##..##..##..######..##..##..##
##....##..######..##..##..##..##..######..##..##########..##
########..........##..........##..........................##
##..############..##..##########..##########################
##............................##..........................##
######..########..##############################..######..##
##......##........##..##..........##......##......##......##
##..############..##..##..##############..##############..##
##................##..##..................................##
##..################..##..##################..######..######
##................##..##..##..................##..##..##..##
######..############..##..######################..######..##
##..##................##..##..............................##
##..################..##..##########..##################..##
##....................##......##..##..##..............##..##
##..####################..######..##########..##########..##
##..##....................................##..............##
##..##..################################..##############..##
##..##..##............##..............................##..##
##..##..############..##################################..##
##........................##..........................##..##
########################..##..######################..##..##
##................................................##......##
############################################################
END
UNITS
aa TRUE
bb FALSE
START
############################################################
##bb..............##..........##........................bb##
################..##########..######..##############..##..##
##........######..##......##..##aa##..##..........##..##..##
##..####..##......##..######..##..##..##..##########..##..##
##....##..######..##..##aa....##..##..##..........##..##..##
####..##....bb##..##..######..##..##..##..######..##..##..##
##....##..######..##..##..##..##..######..##..##########..##
########..........##..........##..........................##
##..############..##..##########..##########################
##............................##..........................##
######..########..##############################..######..##
##......##aa......##..##..........##......##......##......##
##..############..##..##..##############..##############..##
##................##..##..................................##
##..################..##..##################..######..######
##................##..##..##..................##..##..##aa##
######..############..##..######################..######..##
##..##................##..##..............................##
##..################..##..##########..##################..##
##....................##....bb##..##..##............bb##..##
##..####################..######..##########..##########..##
##..##....................................##..............##
##..##..################################..##############..##
##..##..##............##aa............................##..##
##..##..############..##################################..##
##..bb....................##..........................##..##
########################..##..######################..##..##
##..aa............................................##......##
############################################################
END
